Toll-Free Bridging 和 Unmanaged -- toll-free
安全的资源组织方式 -- safe-resource
Playground 与项目协作 -- playground-project
Lock -- lock
delegate -- delegate
代码组织和 Framework -- code-framework
Associated Object -- associated-object
尾递归 -- tail-recursion
列举 enum 类型 -- enum-enumerate
兼容性 -- compatibility
泛型扩展 -- extension-generic
闭包歧义 -- closure-ambiguous
Core Data -- core-data
Swift 中的测试 -- swift-test
属性访问控制 -- property-access
宏定义 define -- define
溢出 -- overflow
sizeof 和 sizeofValue -- sizeof-sizeofvalue
C 代码调用和 @asmname -- asmname
Log 输出 -- log
类型编码 @encode -- type-encode
数组 enumerate -- enumerate
性能考虑 -- performance
Options -- options
文档注释 -- documentation
输出格式化 -- output-format
调用 C 动态库 -- dylib
NSNull -- nsnull
JSON -- json
数学和数字 -- math-number
Swizzle -- swizzle
Playground 可视化 -- playground-capture
Playground 延时运行 -- playground-delay
fatalError -- fatalerror
断言 -- assert
错误和异常处理 -- error-handle
哈希 -- hash
判等 -- equal
print 和 debugPrint -- print
局部 scope -- local-scope
KVO -- kvo
动态类型和多方法 -- multi-method
类型转换 -- type-casting
自省 -- intropection
获取对象类型 -- instance-type
GCD 和延时调用 -- gcd-delay-call
COpaquePointer 和 C convention -- cpointer
C 指针内存管理 -- pointer-memory
Foundation 框架 -- foundation-framework
随机数生成 -- random-number
Swift 命令行工具 -- swift-cli
介绍 -- introduction
方法参数名称省略 -- func-naming